15
15
4 8 13 8 13 3 5 3 5 0
1 2 3
1 2 2
1 2 3 3
1 1 1 0 1 1 1 1 1 1 1 1 1 1 1
0 0 0 0 1 1 1 0 0 0 0 0 0 0 0
0 0 0 0 1 1 1 1 1 1 1 1 1 1 1
0 0 0 0 1 1 1 1 1 1 1 1 1 1 1
0 0 0 0 1 1 1 1 1 1 1 1 1 1 1
0 0 0 0 0 0 0 0 0 0 0 0 1 1 1
0 0 0 0 0 0 0 0 0 0 0 0 1 1 1
0 0 0 1 1 1 1 1 1 1 1 1 1 1 1
0 0 0 1 1 1 1 1 1 1 1 1 1 1 1
0 0 0 1 1 1 1 1 1 1 1 1 1 1 1
0 0 0 1 1 1 0 0 0 0 0 0 0 0 0
1 1 1 1 1 1 0 0 0 0 0 0 0 0 0
1 1 1 1 1 1 0 0 0 0 0 0 0 0 0
1 1 1 1 1 1 0 0 0 0 0 0 0 0 0
0 0 0 0 0 0 0 0 0 0 0 0 0 0 0
0 12
1 12
2 12
3 12
4 12
4 11
4 10
4 9
4 8
5 8
6 8
7 8
8 8
9 8
10 8
11 8
12 8
13 8
13 7
13 6
13 5
13 4
13 3
12 3
11 3
10 3
9 3
8 3
7 3
6 3
5 3
5 2
5 1
5 0